....................................................................................................................................................................................................................................                                   ;               
....................................................................................................................................................................................................................................                                   ;               
....................................................................................................................................................................................................................................                                   ;               
...................................................................................................................................................................................................................................                                    ;               
...................................................................................................................................................................................................................................                                    ;               
......................................    ..................................................................     .................................................................................................................                                     ;               
....................................         .....    ......................................     ......               ..............................................      ........................................................                                     ;               
...................................                       ...............................                                ......    ............................                .....     .........................................                                     ;               
................................                              ......   .............                                                    ..................                                    ...............     ...............                                      ;               
...........................                                                .....                                                          /  ........ /                                             .....              ..........                                      ;               
.......................                                                                                                                   /     /     /                                                                      ...                                       ;               
...................              ..                                                                                                       /     /     /                                                                                                                ;               
...............                           ..                                                                     ..                       /     /     /                                             ..              ..      ...                                        ;               
..      ....            ......^^                   ..                             ..                ......                ..              /     /     /                ..               ......              ..            ^.......                                     ;               
           ;        ............^                           ......       ..                ..        ....                          ..     /           /       ..                ..       ....                   ^^      ^..........                                    ;               
......     ;1  .................. ^                          ....                                   ^^  ^                                 /           /                                                     ^^..... ^ .............                                    ;               
.................................... ^^                                                ^^       ^^....... ^^                                          /                                      ^^         ^^.........................                                    ;               
.........................................^                        ^ ^              ^ ......^^^...............^^  ^                ^^ ^                /                               ^^ ^ ......  ^ ^..............................                                   ;               
............................................^                 ^^ .....^^         ^................................^ ^^ ^      ^^ ^.....^^ ^           /                  ^       ^^ ................................................                                   ;               
..............................................^^  ^       ^   ............. ^ .......................................... ^^ ^ ..............^ ^                    ^^ .....  ^ .....................................................;;;;;;;;;;;;;;;;;;;;;;;;;;;;;;;;;;;;               
....................................................  ^^ ....................................................................................... ^^^ ^         ^^...................................................................                                                   
.......................................................................................................................................................  ^^ ^.......................................................................                                                   
...................................................................................................................................................................................................................................                                                    
...................................................................................................................................................................................................................................                                                    
..................................................................................................................................................................................................................................                                                     
..................................................................................................................................................................................................................................                                                     
.................................................................................................................................................................................................................................                                                      
.................................................................................................................................................................................................................................                                                      