           ;                                                                                                       ;             
           ;                                                                                                       ;              
           ;                                                                                                       ;             
           ;                                                                                                       ;             
           ;                                                                                                       ;             
           ;                                                                                                       ;             
           ;                                                                                                       ;             
           ;                                                                                                       ;             
           ;                                                                                                       ;             
           ;   1                                                                                                   ;             
           ;                                                                                               ....... ;             
           ;                                                                                            ...............          
           ;........                                 ..............                                 ........................     
        ...................                        ...........................               ....................................
   .............................              ...................................................................................
.................................................................................................................................
.................................................................................................................................
.................................................................................................................................
.................................................................................................................................
.................................................................................................................................
.................................................................................................................................