...........................................................................................................................................................................................................           
...........................................................................................................................................................................................................            
...........................................................................................................................................................................................................            
...........................................................................................................................................................................................................            
...........................................................................................................................................................................................................            
................................................................................................................................                    .......................................................            
...........            ...............................                 ................              ......................                                           .....................................            
                                  ..........                                                                                                                                                                           
                                                                                                                                                                                                                       
																														..				.				...										                       
                                                                                                                                                                                                                       
										...						...						...																					...					                       
						...						...		...					..						.....						.			..													                       
                             ...                             ...                                                ...                                  ....                        .                                     
                                            ..                           ...          ..                ...                           ..                          ...   ....                ...                        
                ....                  ..            ..         ...                           ...                 .             ..                   .                                                                  
          ...                  ...                                                                                                         .                                                                           
  1                   ....                                 ...                 ..                           ...                                                ...        ...                                          
........///////////                 ////////////                                             ...                          ///////////////////////                                                                      
.................../////////////////............////////////////////////////////////////                ///////////////.......................//////////////////////           ////////////////////........            
........................................................................................////////////////............................................................///////////............................            
...........................................................................................................................................................................................................            
...........................................................................................................................................................................................................            
